F 64 64

~ 3~ 3~f1~ 3~ 3~ 3~ 3~ 3~ 3~ 3~ 3~ 3~ 3~ 0~ 0~ 0~ 0~ 0~ 0~ 0~ 0~ 0~ 0~ 0~ 0~ 0~ 0~ 0~ 0~ 0~ 0~ 0~ 0~ 0~ 0~ 0~ 0~ 0~ 0~ 0~ 0~ 0~ 0~ 3~ 3~ 3~ 3~ 3~ 3~ 3~ 3~ 3~ 3~ 3~ 3~ 3~ 3~ 3~ 3~ 3~ 3~ 3~ 3~ 3
~ 3~ 3~ 3~ 3~ 3~ 3~ 3~ 3~ 3~ 3~ 3~ 3~ 3~ 0~ 0~ 0~ 0~ 0~ 0~ 0~ 0~ 0~ 0~ 0~ 0~ 0~ 0~ 0~ 0~ 0~ 0~ 0~ 0~ 0~ 0~ 0~ 0~ 0~ 0~ 0~ 0~ 0~ 0~ 3~ 3~ 3~ 3~ 3~ 3~ 3~ 3~ 3~ 3~ 3~ 3~ 3~ 3~ 3~ 3~ 3~ 3~ 3~ 3~ 3
~ 3~ 3~ 3~ 3~ 3~ 3~ 3~ 3~ 3~ 3~ 3~ 3~ 3~ 0~ 0~ 0~ 0~ 0~ 0~ 0~ 0~ 0~ 0~ 0~ 0~ 0~ 0~ 0~ 0~ 0~ 0~ 0~ 0~ 0~ 0~ 0~ 0~ 0~ 0~ 0~ 0~ 0~ 0~ 3~ 3~ 3~ 3~ 3~ 3~ 3~ 3~ 3~ 3~ 3~ 3~ 3~ 3~ 3~ 3~ 3~ 3~ 3~ 3~ 3
~ 3~ 3~ 3~ 3~ 3~F1~ 3~ 3~ 3~ 3~ 3~ 3~ 3~ 0~ 0~ 0~ 0~ 0~ 0~ 0~ 0~ 0~ 0~ 0~ 0~ 0~ 0~ 0~ 0~ 0~ 0~ 0~ 0~ 0~ 0~ 0~ 0~ 0~ 0~ 0~ 0~ 0~ 0~ 0~ 0~ 3~ 3~ 3~ 3~ 3~ 3~ 3~ 3~ 3~ 3~ 3~ 3~ 3~ 3~ 3~ 3~ 3~ 3~ 3
~ 3~ 3~ 3~ 3~ 3~ 3~ 3~ 3~ 3~ 3~ 3~ 3~ 3~ 0~ 0~ 0~ 0~ 0~ 0~ 0~ 0~ 0~ 0~ 0~ 0~ 0~ 0~ 0~ 0~ 0~ 0~ 0~ 0~ 0~ 0~ 0~ 0~ 0~ 0~ 0~ 0~ 0~ 0~ 0~ 0~ 3~ 3~ 3~ 3~ 3~ 3~ 3~ 3~ 3~ 3~ 3~ 3~ 3~ 3~ 3~ 3~ 3~ 3~ 3
~ 3~ 3~ 3~ 3~F1~ 3~ 3~ 3~ 3~ 3~ 3~ 3~ 3~ 0~ 0~ 0~ 0~ 0~ 0~ 0~ 0~ 0~ 0~ 0~ 0~ 0~ 0~ 0~ 0~ 0~ 0~ 0~ 0~ 0~ 0~ 3~ 3~ 3~ 3~ 3~ 3~ 3~ 3~ 3~ 3~ 3~ 3~ 3~ 3~ 3~ 3~ 3~ 3~ 3~ 3~ 3~ 3~ 3~ 3~ 3~ 3~ 3~ 3~ 3
~ 3~ 3~ 3~ 3~ 3~ 3~ 3~ 3~ 3~ 3~*3~ 3~ 3~ 0~ 0~ 0~ 0~ 0~ 0~ 0~ 0~ 0~ 0~ 0~ 0~ 0~ 0~ 0~ 0~ 0~ 0~ 0~ 0~ 0~ 0~ 3~ 3~ 3~ 3~ 3~ 3~ 3~ 3~ 3~ 3~ 3~ 3~ 3~ 3~ 3~ 3~ 3~ 3~ 3~ 3~ 3~ 3~ 3~ 3~ 3~ 3~ 3~ 3~ 3
~ 3~ 3~F1~ 3~ 3~ 3~ 3~ 3~ 3~ 3~ 3~ 3~ 3~ 0~ 0~ 0~ 0~ 0~ 0~ 0~ 0~ 0~ 0~ 0~ 0~ 0~ 0~ 0~ 0~ 0~ 0~ 0~ 0~ 0~ 0~ 3~ 3~ 3~ 3~ 3~ 3~ 3~ 3~ 3~ 3~ 3~ 3~ 3~ 3~ 3~ 3~ 3~ 3~f1~ 3~ 3~ 3~ 3~ 3~ 3~ 3~ 3~ 3~ 3
~ 3~ 3~ 3~ 3~ 3~ 3~ 3~ 3~ 3~ 3~ 3~ 3~ 3~ 0~ 0~ 0~ 0~ 0~ 0~ 0~ 0~ 0~ 0~ 0~ 0~ 0~ 0~ 0~ 0~ 0~ 0~ 0~ 0~ 0~ 0~ 3~ 3~ 3~ 3~ 3~ 3~ 3~ 3~ 3~ 3~ 3~ 3~ 3~ 3~ 3~ 3~ 3~ 3~ 3~ 3~ 3~ 3~ 3~ 3~ 3~ 3~ 3~ 3~ 3
~ 3~ 3~ 3~ 3~ 3~ 3~ 3~ 3~*3~ 3~ 3~ 3~ 3~ 0~ 0~ 0~ 0~ 0~ 0~ 0~ 0~ 0~ 0~ 0~ 0~ 0~ 0~ 0~ 0~ 0~ 0~ 0~ 0~ 0~ 0~ 3~ 3~ 3~ 3~ 3~ 3~ 3~ 3~ 3~ 3~ 3~ 3~ 3~ 3~ 3~ 3~ 3~ 3~ 3~ 3~ 3~ 3~ 3~ 3~ 3~ 3~ 3~ 3~ 3
~ 3~ 3~ 3~ 3~ 3~ 3~ 3~ 3% 3% 3. 3. 3. 3. 0% 0~ 0~ 0~ 0~ 0~ 0~ 0~ 0~ 0~ 0~ 0~ 0~ 0~ 0~ 0~ 0~ 0~ 0~ 0~ 0~ 0~ 3~ 3~ 3~ 3~ 3~ 3~ 3. 3~ 3~ 3~ 3~ 3^ 3. 3. 3. 3~ 3~ 3~ 3~ 3. 3~ 3~ 3~ 3~ 3~ 3~ 3~ 3~ 3
~ 3~ 3~ 3~ 3~ 3~ 3~ 3~ 3~ 3~ 3. 3^ 3~ 3% 0^ 0~ 3~ 3~ 3~ 3~ 3~ 3~ 3~ 3~ 3~ 3~ 3~ 3~ 3~ 3~ 3~ 3~ 0~ 0~ 0~ 0~ 3~ 3~ 3~ 3~ 3% 3. 3~ 3~ 3~ 3~ 3^ 3. 3^ 3^ 3^ 3~ 3~ 3~ 3~ 3^ 3% 3~ 3~ 3~ 3~ 3~ 3~ 3~ 3
~ 3~ 3~ 3~ 3~ 3~ 3~ 3~ 3^ 3. 3~ 3~ 3~ 3~ 0~ 0~ 3~ 3~ 3~ 3~ 3~ 3~ 3~ 3~ 3~ 3~ 3~ 3~ 3~ 3~ 3~ 3~ 0~ 0~ 0~ 0~ 3~ 3~ 3~ 3~ 3~ 3~ 3~ 3~f1~ 3. 3^ 3. 3^ 3^ 3. 3~ 3~ 3~ 3~ 3~ 3~ 3~ 3~ 3~ 3~ 3~ 3~ 3~ 3
~ 3~ 3~ 3~ 3~ 3~ 3~ 3~ 3. 3^ 3. 3~ 0~ 0~ 0~ 0. 3~ 3~ 3~ 3~ 3~ 3~ 3~ 3~ 3~ 3~ 3~ 3~ 3~ 3~ 3~ 3~ 0~ 0~ 0~ 0~ 3~ 3~ 3~ 3~ 3~ 3~ 3~ 3. 3~ 3^ 3^ 3^ 3^ 3^ 3^ 3^ 3. 3. 3~ 3~ 3~ 3~ 3~ 3~ 3~ 3~ 3~ 3~ 3
~ 3~ 3~ 3~ 3~ 3~ 3~ 3~ 3~ 3~ 3# 3# 0~ 0. 0~ 0^ 3^ 3% 3~ 3~ 3~ 3~ 3~ 3~*3~ 3~ 3~ 3~ 3~ 3~ 3~ 3~ 0~ 0~ 0~ 0% 3~ 3~ 3~ 3~ 3~ 3~ 3. 3^ 3^ 3. 3. 3^ 3^ 3. 3. 3^ 3^ 3^ 3^ 3^ 3^ 3^ 3. 3~ 3~ 3~ 3% 3~ 3
~ 0~ 0. 0^ 0~ 0~ 0~ 0~ 0~ 0~ 0. 0. 0. 0% 0~ 0^ 3# 3. 3~ 3~ 3~ 3~ 3~ 3~ 3~ 3~ 3~ 3~ 3~ 3~ 3~ 3~ 0~ 0~ 0% 0% 3% 3~ 3~ 3~ 3~ 3~ 3. 3^ 3^ 3. 3. 3^ 3^ 3. 3^ 3. 3^ 3^ 3^ 3^ 3^ 3^ 3^ 3~ 0~ 0~ 0~ 0~ 0
~ 0. 0. 0. 0. 0. 0^ 0^ 0. 0. 0. 0. 0~ 0. 0% 0% 3~ 3^ 3% 3~ 3~*3~ 3~ 3~ 3~ 3~ 3~ 3~ 3~E3~ 3~ 3~ 0~ 0^ 0^ 0^ 3# 3^ 3% 3. 3^ 3^ 3^ 3# 3^ 3^ 3^*3. 3. 3. 3. 3. 3^ 3. 3^ 3^ 3^ 3^ 3^ 3^ 0^ 0^ 0# 0~ 0
~ 0~ 0. 0. 0. 0. 0. 0^ 0. 0. 0. 0. 0. 0. 0^ 0% 3~ 3. 3. 3~ 3~ 3~ 3~ 3~ 3~ 3~ 3~ 3~ 3~ 3~ 3~ 3~ 0~ 0^ 0^ 0^ 3^ 3# 3^ 3^ 3^ 3^ 3^ 3. 3^ 3^ 3^ 3. 3. 3. 3. 3^F1^ 3^ 3^ 3. 3^ 3^ 3^ 3^ 0^ 0. 0^ 0. 0
~ 0# 0^ 0^ 0^ 0. 0. 0. 0. 0. 0. 0. 0^ 0^ 0. 0^ 3~ 3% 3. 3~ 3~ 3~ 3~ 3~ 3~ 3~*3~ 3~ 3~ 3~ 3~ 3~ 0% 0^ 0. 0^ 3^ 3. 3^ 3^ 3^ 3^ 3^ 3^*3^ 3^ 3^ 3^ 3. 3. 3. 3. 3^ 3^ 3. 3. 3^ 3^ 3. 3. 0^ 0^ 0. 0^ 0
~ 3~ 3^ 3. 3. 3. 3. 3. 3^ 3^ 3. 3. 3^ 3^ 0% 0% 3~ 3. 3. 3~ 3~ 3~ 3~F1~ 3~ 3~ 3~ 3~ 3~ 3~ 3~ 3% 0# 0# 0. 0# 3# 3^ 3^ 3^ 3^ 3# 3^ 3^ 3^ 3^ 3. 3. 3^ 3. 3. 3^ 3^ 3^ 3^ 3. 3^ 3^ 3. 3^ 3^ 3^ 3~ 3~ 3
~ 3^ 3^ 3. 3. 3. 3. 3. 3^ 3. 3. 3. 3. 3^ 0~ 0~ 3~ 3^ 3~ 3~ 3~ 3~ 3~ 3~ 3~ 3~ 3~ 3~ 3~ 3% 3~ 3# 0# 0^ 0# 0# 3. 3^ 3^ 3^ 3^ 3^ 3^ 3^ 3^ 3^ 3^ 3.F1. 3. 3. 3. 3. 3^ 3^ 3. 3^ 3^ 3. 3. 3^ 3~ 3~ 3~ 3
~ 3. 3^ 3. 3% 3. 3. 3. 3. 3. 3^ 3. 3. 3. 3~ 3~ 3~ 3^ 3~ 3~ 3~ 3~ 3~ 3~ 3~ 3~ 3~ 3~ 3~ 3% 3~ 3% 0# 0# 0^ 0. 0^ 0# 0^ 0^ 3. 3^ 3^ 3^ 3^ 3^ 3^ 3. 3. 3. 3. 3. 3^ 3. 3^ 3. 3^ 3^ 3~ 3~ 3. 3~ 3~ 3~ 3
~ 3~ 3. 3% 3~ 3~ 3. 3. 3. 3. 3. 3. 3. 3# 3~ 3~ 3~ 3. 3^ 3. 3~ 3~ 3~ 3~ 3~ 3~ 3~ 3~ 3~ 3~ 3~ 3. 0. 0% 0^ 0# 0^ 0# 0# 0^ 3. 3^ 3^ 3^ 3^ 3^ 3^ 3^ 3. 3^ 3. 3. 3^ 3. 3. 3. 3~ 3~ 3~ 3^ 3~ 3~ 3~ 3~ 3
~ 3~ 3~ 3~ 3~ 3~ 3~ 3# 3. 3. 3. 3. 3. 3^ 3^ 3. 3. 3. 3. 3. 3~ 3~ 3~ 3~ 3~ 3~ 3~ 3~ 3~ 3~ 3. 3. 3# 3. 3# 3# 3# 3# 3^ 3^ 3. 3^ 3# 3^ 3^ 3^ 3. 3. 3. 3. 3.*3. 3. 3. 3^ 3~ 3~ 3~ 3^ 3. 3~ 3~ 3~ 3~ 3
~ 3~ 3~ 3~ 3~ 3~ 3~ 3~ 3. 3. 3. 3. 3. 3. 3. 3^ 3^ 3. 3. 3. 3% 3~ 3~ 3~ 3~ 3~ 3~ 3~ 3~ 3. 3% 3# 3# 3# 3# 3# 3# 3^ 3^ 3^ 3^ 3. 3^ 3. 3^ 3^ 3. 3. 3. 3. 3. 3. 3. 3. 3^ 3# 3~ 3~ 3. 3~ 3~ 3~ 3~ 3~ 3
~ 3~ 3~ 3~ 3~ 3~ 3~ 3~ 3. 3. 3. 3. 3. 3. 3. 3^ 3^ 3. 3^ 3. 3. 3~ 3~ 3~ 3~ 3~ 3~ 3~ 3~ 3^ 3# 3# 3# 3# 3^ 3^ 3^ 3# 3# 3^ 3. 3^ 3. 3. 3. 3^ 3. 3. 3. 3. 3. 3. 3. 3^ 3^ 3^ 0~ 0~ 0~ 0~ 3~ 3~ 3~ 3~ 3
~ 3~ 3~ 3~ 3~f1~ 3~ 3~ 3^ 3^ 3. 3. 3. 3. 3. 3^ 3. 3^ 3^ 3. 3~ 3~ 3~ 3~ 3~ 3~ 3~ 3~ 3~ 3~ 3# 3# 3# 3# 3# 3# 3. 3# 3^ 3. 3^ 3^ 3^ 3. 3. 3^ 3. 3. 3. 3. 3. 3. 3. 3^ 3^ 3~ 0~ 0~ 0~ 0~ 3~ 3~ 3~ 3~ 3
~ 3~ 3~ 3~f1~ 3~ 3~ 3~ 3. 3^ 3. 3. 3. 3. 3. 3. 3. 3# 3# 3~ 3~ 3~ 3~ 3~ 3~ 3~ 3~ 3~ 3~ 3~ 3# 3# 3# 3# 3# 3# 3~ 3~ 3~ 3. 3. 3. 3^ 3. 3. 3. 3. 3. 3. 3. 3. 3. 3. 3^ 3% 3~ 0~ 0~ 0~ 0~ 3~ 3~ 3~ 3~ 3
~ 3~ 3~ 3~ 3~f1~f1~ 3~ 3. 3^ 3.F1. 3. 3. 3^ 3. 3^ 3% 3~ 3~ 3~ 3~ 3~ 3~ 3~ 3~ 3~ 3~ 3~ 3^ 3% 3~ 3~ 3~ 3# 3# 3~ 3~ 3# 3. 3# 3# 3. 3^ 3. 3. 3. 3. 3. 3. 3. 3. 3. 3% 3~ 3~ 0~ 0~ 0~ 0~*3~ 3~ 3~ 3~ 3
~ 3~ 3~ 3~ 3~ 3~F1~ 3~f1^ 3^ 3. 3. 3. 3.f1^ 3^ 3^ 3~ 3~ 3~ 3~ 3~ 3~ 3~ 3~ 3~ 3~ 3~ 3~ 3~ 3~ 3~ 3~ 3~ 3~ 3~ 3. 3^ 3. 3. 3# 3# 3^ 3^ 3. 3. 3. 3# 3. 3. 3. 3^ 3. 3~ 0~ 0# 0~ 0~ 0~ 0~ 3~ 3~ 3~ 3~ 3
~ 3~ 3~ 3~ 3~ 3~ 3~ 3~ 3~ 3% 3^ 3. 3. 3^ 3^ 3^ 3~ 3~ 3~ 3~ 3~ 3~ 3~ 3~ 3~ 3~ 3~ 3~ 3~ 3^ 3^ 3# 3~ 3~ 3~ 3~ 3~ 3. 3# 3. 3. 3^ 3. 3# 3. 3# 3# 3# 3# 3. 3. 3^ 3~*3~ 0# 0# 0~ 0~ 0~ 0~ 3~ 3~ 3~ 3~ 3
~ 3~ 3~ 3~ 3~ 3~ 3~ 3~ 3~F1~ 3. 3. 3. 3^ 3^ 3^ 3~ 3~ 3~ 3~ 3~ 3~ 3~ 3~ 3~ 3~ 3~ 3~ 3~ 3# 3. 3# 3^ 3%f1~ 3~ 3~ 3. 3^ 3^ 3. 3^ 3^ 3^ 3^ 3#f1# 3# 3. 3. 3. 3^ 3. 3~ 0# 0~ 0~ 0~*3~ 3~ 3~ 3~ 3~ 3~ 3
~ 3~ 3~ 3~ 3~ 3~ 3~ 3~ 3~ 3~ 3~ 3^ 3^ 3~ 3~ 3~ 3~ 3~ 3~ 3~ 3~ 3~ 3~ 3~ 3~F1~ 3~ 3~ 3# 3^ 3^ 3^ 3^ 3. 3^ 3^ 3^ 3^ 3~ 3^ 3# 3~ 3~ 3. 3^ 3# 3# 3# 3. 3. 3^ 3. 3~ 3~ 0~ 0~ 0~ 0~ 3~ 3~ 3~ 3~ 3~ 3~ 3
~ 3~ 3~ 3~ 3~ 3~ 3~ 3~ 3~ 3~ 3~ 3^ 3. 3~ 3~ 3~ 3~ 3~ 3~ 3~F1~ 3~f1~ 3~ 3~ 3~ 3~ 3~ 3# 3^F1^ 3^ 3^ 3^ 3^ 3^ 3^ 3^ 3~ 3~ 3# 3# 3~ 3. 3. 3# 3^ 3^ 3. 3. 3^ 3. 3~ 3~ 3~ 3~ 3~ 3~ 3~ 3~ 3~ 3~ 3~ 3~ 3
~ 3~ 3~ 3~ 3~ 3~ 3~ 3~ 3~ 3~ 3~ 3~ 3. 3~ 3~ 3~ 3~ 3~ 3~ 3~ 3~ 3~ 3~ 3~ 3~ 3~ 3~ 3% 3# 3^ 3^ 3^ 3^ 3^ 3^ 3. 3^ 3^ 3. 3~ 3# 3# 3~ 3^ 3^ 3^ 3~ 3# 3^ 3^ 3^ 3# 3~ 3~ 3~ 3~*3~ 3~ 3~ 3~ 3~ 3~ 3~ 3~ 3
~ 3~ 3~ 3~ 3~ 3~ 3~ 3~ 3~ 3~F1~ 3~ 3~ 3% 3# 3~ 3~ 3~ 3~ 3~ 3~ 3~ 3~ 3~ 3~ 3~ 3~ 3# 3# 3^ 3^ 3^ 3^ 3^ 3. 3. 3^ 3# 3^ 3~ 3~ 3~ 3~ 3~ 3. 3~ 3~ 3~ 3# 3# 3# 3# 3# 3~ 3~ 3~ 3~ 3~ 3~ 3~ 3~ 3~ 3~ 3~ 3
~ 3~ 3~ 3~ 3~ 3~ 3~ 3~ 3~ 3~ 3~ 3~ 3~ 3~ 3~ 3% 3~ 3~ 3% 3~ 3~ 3~F1~ 3~ 3~ 3~ 3~ 3~ 3# 3^ 3# 3^ 3^ 3. 3. 3. 3^ 3^ 3^ 3~ 3~ 3~ 3~ 3~ 3% 3~ 3~ 3% 3. 3# 3% 3~ 3# 3~ 3~ 3~ 3~ 3~ 3~ 3~ 3~ 3~ 3~ 3~ 3
~ 3~ 3~ 3~ 3~ 3~ 3~ 3~ 3~ 3~ 3~ 3~ 3~ 3~ 3~ 3~ 3% 3^ 3^ 3# 3~ 3~ 3~ 3~ 3~ 3~ 3~ 3~ 3# 3# 3# 3# 3^ 3^ 3^ 3^ 3. 3. 3^ 3~ 3~ 3~ 3~ 3~ 3~ 3~ 3~ 3~ 3~ 3~ 3~ 3~ 3~ 3~ 3~ 3~ 3~ 3~ 3~ 3~ 3~ 3~ 3~ 3~ 3
~F1~ 3~ 3~ 3~ 3~ 3~ 3~ 3~ 3~ 3~ 3~ 3~ 3~ 3~ 3~ 3^ 3. 3^ 3# 3^ 3~ 3% 3~ 3~F1~ 3~ 3~ 3~ 3~ 3~ 3~ 3# 3# 3^ 3. 3^ 3^ 3% 3~ 3~ 3~ 3~ 3~ 3~ 3~ 3~ 3~ 3~ 3. 3^ 3# 3~ 3~ 3~ 3~ 3~ 3~ 3~ 3~ 3~ 3~ 3~ 3~ 3
~ 3~ 3~ 3~ 3~F1~ 3~ 3~ 3~ 3~ 3~ 3~ 3~ 3~ 3~ 3# 3^ 3^f1^ 3^ 3# 3# 3. 3~ 3~ 3~ 3~ 3~ 3~ 3~ 3~ 3~ 3# 3# 3# 3. 3. 3# 3~ 3~ 3~ 3~ 3~ 3~ 3~ 3~ 3~ 3~ 3% 3. 3~ 3~ 3~ 3~ 3~ 3~ 3~ 3~ 3~ 3~ 3~ 3~ 3~ 3~ 3
~ 3~ 3~ 3~ 3~ 3~ 3~ 3~ 3~ 3~ 3~ 3~ 3~ 3~ 3# 3^ 3# 3# 3^F1^ 3# 3# 3. 3% 3~ 3~ 3~ 3~ 3~ 3~ 3~ 3~ 3% 3# 3# 3^ 3. 3# 3~ 3~ 3~ 3~ 3~ 3~ 3~ 3~ 3~ 3~ 3~ 3~ 3~ 3. 3~ 3~ 3~ 3~ 3~ 3~ 3~F1~ 3~ 3~ 3~ 3~ 3
~ 3~ 3~ 3~ 3~ 3~ 3~ 3~ 3~ 3~ 3~ 3~ 3~ 3~ 3# 3# 3. 3. 3^ 3# 3. 3^ 3^ 3^ 3~ 3~ 3~ 3~ 3~ 3~ 3~ 3~ 3~ 3^ 3^f1^ 3. 3^ 3~ 3~ 3~ 3~ 3~ 3~ 3~ 3~ 3~ 3~ 3~ 3~ 3% 3~ 3% 3~ 3~ 3. 3~ 3~f1~ 3~ 3~ 3~ 3~ 3~ 3
~ 3~ 3~ 3~F1~ 3~ 3~ 3~ 3~ 3~ 3~ 3~ 3~ 3~ 3. 3. 3# 3# 3# 3^ 3#F1# 3^ 3~ 3~ 3~ 3~ 3~ 3~ 3~ 3~ 3~ 3~ 3^ 3. 3^ 3^ 3% 3~ 3~ 3# 3~ 3~ 3~ 3~ 3~ 3~ 3~ 3~ 3~ 3~ 3~ 3~ 3~ 3# 3~ 3~ 3~ 3~ 3~F1~ 3~ 3~ 3~ 3
~ 3~ 3~ 3~ 3~ 3~ 3~ 3~ 3~ 3~F1~ 3~ 3~ 3~ 3~ 3# 3% 3% 3# 3^ 3# 3^ 3# 3~ 3~ 3~ 3~ 3~ 3~ 3~ 3~ 3~ 3~ 3. 3^ 3^ 3^ 3% 3~ 3# 3# 3~ 3~ 3~ 3~ 3~ 3~ 3~ 3~ 3~ 3~ 3~ 3. 3^ 3^ 3. 3~ 3~ 3~ 3~ 3~ 3~ 3~ 3~ 3
~ 3~ 3~ 3~f1~ 3~ 3~ 3~ 3~ 3~ 3~ 3~ 3~ 3~ 3~ 3% 3% 3% 3^ 3^ 3^ 3# 3% 3~ 3~ 3~ 3~ 3~ 3~ 3~ 3~ 3~ 3~ 3^ 3. 3^ 3# 3~ 3~F1# 3~ 3~ 3~ 3~ 3~ 3~ 3~ 3~ 3~ 3~ 3~ 3. 3^ 3^ 3^ 3# 3. 3~ 3~ 3~f1~ 3~ 3~ 3~ 3
~ 3~ 3~ 3~ 3~F1~ 3~f1~ 3~ 3~ 3~ 3~ 3~ 3~ 3~ 3% 3% 3% 3# 3# 3# 3% 3~F1~ 3~ 3~ 3~ 3~ 3~ 3~ 3~ 3~ 3% 3# 3^ 3# 3# 3~ 3~ 3~ 3~ 3~ 3~ 3~ 3~ 3~ 3~ 3~ 3~ 3~ 3~ 3# 3# 3# 3# 3# 3# 3# 3~ 3~f1~ 3~ 3~ 3~ 3
~ 3~ 3~ 3~f1~ 3~ 3~ 3~ 3~ 3~ 3~ 3~ 3~ 3~ 3~ 3% 3% 3% 3# 3# 3# 3~ 3~ 3~ 3~ 3~ 3~ 3~ 3~ 3~ 3~ 3~ 3~ 3% 3^ 3. 3# 3~ 3~ 3~ 3~f1~ 3~F1~ 3~ 3~ 3~ 3~ 3~ 3~ 3~ 3^ 3# 3# 3# 3# 3^ 3#f1~ 3~ 3~F1~ 3~ 3~ 3
~ 3~ 3~ 3~ 3~ 3~ 3~ 3~ 3~ 3~ 3~ 3~ 3~ 3~ 3~ 3% 3# 3# 3# 3# 3# 3~ 3~ 3~ 3~ 3~ 3~ 3~ 3~ 3~ 3~ 3~ 3~ 3~ 3# 3% 3~ 3~ 3~ 3~ 3~ 3~ 3~ 3~ 3~ 3~ 3~ 3~ 3~ 3~ 3~ 3% 3% 3# 3% 3# 3#f1# 3~ 3~ 3~ 3~ 3~ 3~ 3
~ 3~ 3~ 3~ 3~ 3~ 3~ 3~ 3~ 3~ 3~ 3~ 3~ 3~ 3~ 3% 3% 3% 3^ 3# 3~ 3~ 3~ 3~ 3~F1~ 3~ 3~ 3~ 3~ 3~ 3~ 3~ 3~ 3% 3~ 3~ 3~ 3~ 3~ 3~ 3~ 3~ 3~ 3~ 3~ 3~ 3~ 3~ 3~ 3~ 3% 3~ 3# 3~ 3# 3% 3% 3~f1~ 3~ 3~ 3~ 3~ 3
~ 3~ 3~ 3~*3~ 3~ 3~ 3~ 3~ 3~ 3~ 3~ 3~ 3~ 3~ 3% 3% 3# 3^ 3~ 3~ 3~ 3~ 3~ 3~ 3~ 3~ 3~ 3~ 3~ 3~ 3~ 3~ 3~ 3~ 3~ 3~ 3~F1~ 3~ 3~ 3~F1~ 3~ 3~ 3~ 3~ 3~ 3~ 3~ 3~ 3~ 3~ 3~ 3~ 3~ 3% 3~ 3~ 3~ 3~ 3# 3~ 3~ 3
~ 3~ 3~ 3~ 3~ 3~ 3~ 3~ 3~ 3~ 3~ 3~ 3~ 3~ 3~ 3~ 3% 3# 3# 3~ 3~ 3~ 3~ 3~ 3~ 3~ 3~ 3~ 3~ 3~ 3~ 3~ 3~ 3~ 3~ 3~ 3~ 3~ 3~ 3~ 3~ 3~ 3~ 3~ 3~ 3~ 3~ 3~ 3~ 3~ 3~ 3~ 3~ 3~ 3~ 3~ 3~ 3~f1~ 3~ 3~ 3. 3~ 3~ 3
~ 3~ 3~ 3~ 3~ 3~ 3~ 3~ 3~ 3~ 3~ 3~ 3~ 3~*3~ 3~ 3~ 3# 3^ 3~ 3~ 3~ 3~ 3~ 3~ 3~ 3~ 3~ 3~ 3~ 3~ 3~ 3~ 3~ 3~ 3~ 3~ 3~ 3~ 3~ 3~ 3~ 3~ 3~ 3~ 3~ 3~ 3~ 3~ 3~ 3~ 3~ 3~ 3~ 3~ 3~ 3~ 3~ 3~ 3~ 3~ 3~ 3~ 3~ 3
~ 3~ 3~ 3~ 3~ 3~ 3~ 3~ 3~ 3~ 3~ 3~ 3~ 3~ 3~ 3~ 3~ 3# 3% 3~ 3~ 3~ 3~ 3~ 3~ 3~ 3~ 3~ 3~ 3~ 3~ 3~ 3~ 3~ 3~ 3~ 3~ 3~ 3~ 3~ 3~ 3~ 3~ 3~ 3~ 3~ 3~ 3~ 3~ 3~ 3~ 3~ 3~ 3~ 3~ 3~ 3~ 3~ 3~ 3~ 3~ 3~ 3~ 3~ 3
~ 3~ 3~ 3~ 3~ 3~ 3~ 3~ 3~ 3~ 3~ 3~ 0~ 0~ 0~ 0~ 3~ 3# 3% 3~ 3~ 3~ 3~ 3~ 3~ 3~ 3~ 3~ 3~ 3~ 3~ 3~ 3~ 3~ 3~ 3~ 3~ 3~ 3~ 3~ 3~ 3~ 3~ 3~ 3~ 3~ 3~ 3~ 3~ 3~ 3~f1~ 3~ 3~ 3~F1~ 3~ 3~ 3~ 3~ 3~ 3~ 3~ 3~ 3
~ 3~ 3~ 3~ 3~ 3~ 3~ 3~ 3~ 3~ 3~ 3~ 0~ 0~ 0~*0~ 3~ 3% 3% 3~ 3~ 3~ 3~ 3~f1~ 3~ 3~ 3~ 3~ 3~ 3~ 3~ 3~ 3~ 3~ 3~ 3~ 3~ 3~ 3~ 3~ 3~ 3~ 3~ 3~ 3~ 3~ 3~ 3~ 3~ 3~ 3~ 3~ 3~ 3~ 3~ 3~ 3~ 3~ 3~ 3~ 3~ 3~ 3~ 3
~ 3~ 3~ 3~ 0~ 0~ 0~ 0~ 0~*0~ 0~ 0~ 0~ 0~ 0~ 0~ 3~ 3~ 3~ 3~ 3~ 3~ 3~ 3~ 3~ 3~ 3~ 3~ 3~ 3~ 3~ 3~ 3~ 3~ 3~ 3~ 3~ 3~ 3~ 3~ 3~ 3~ 3~ 3~ 3~ 3~ 3~ 3~ 3~ 3~ 3~ 3~ 3~ 3~ 3~ 3~ 3~ 3~ 3~ 3~ 3~ 3~ 3~ 3~ 3
~ 3~ 3~ 3~ 0~ 0~ 0~ 0~ 0~ 0~ 0~ 0~ 0~ 0~ 0~ 0~ 3~ 3~ 3~ 3~ 3~ 3~ 3~ 3~ 3~ 3~ 3~ 3~ 3~ 3~ 3~ 3~ 3~ 3~ 3~ 3~ 3~ 3~ 3~ 3~ 3~ 3~ 3~ 3~ 3~ 3~ 3~ 3~ 3~ 3~ 3~ 3~ 3~ 3~ 3~ 3~F1~ 3~ 3~ 3~ 3~ 3~ 3~ 3~ 3
~ 3~ 3~ 3~ 3~ 3~ 3~ 3~ 3~ 3~ 3~*3~ 0~ 0~ 0~ 0~ 3~ 3~ 3~ 3~ 3~ 3~ 3~ 3~ 3~ 3~ 3~ 3~ 3~ 3~ 3~ 3~ 0~ 0~ 0~ 0~ 0~ 0~ 0~ 0~ 0~ 0~ 0~ 0~ 3~ 3~ 3~ 3~ 3~ 3~ 3~ 3~ 3~ 3~ 3~ 3~ 3~ 3~ 3~ 3~ 3~ 3~ 3~ 3~ 3
~ 3~ 3~ 3~ 3~ 3~ 3~ 3~ 3~ 3~ 3~ 3~ 0~ 0~*0~ 0~ 3~ 3~ 3~ 3~ 3~ 3~ 3~ 3~ 3~ 3~ 3~ 3~ 3~ 3~ 3~ 3~ 0~ 0~ 0~ 0~ 0~ 0~ 0~ 0~ 0~ 0~ 0~ 0~ 3~ 3~ 3~ 3~ 3~ 3~ 3~ 3~F1~ 3~ 3~ 3~ 3~ 3~ 3~ 3~ 3~ 3~ 3~ 3~ 3
~ 3~ 3~ 3~ 3~ 3~ 3~ 3~ 3~ 3~ 3~ 3~ 3~ 3~ 0~ 0~ 3~ 3~ 3~ 3~ 3~ 3~ 3~ 3~ 3~ 3~ 3~ 3~ 3~ 3~ 3~ 3~ 0~ 0~ 0~ 0~ 0~ 0~ 0~ 0~ 0~ 0~ 0~ 0~ 3~ 3~ 3~ 3~ 3~ 3~ 3~ 3~ 3~ 3~ 3~ 3~ 3~ 3~ 3~ 3~ 3~ 3~ 3~ 3~ 3
~ 3~ 3~ 3~ 3~ 3~ 3~ 3~ 3~ 3~ 3~ 3~ 3~ 3~ 0~ 0~ 3~ 3~ 3~ 3~ 3~ 3~ 3~ 3~ 3~ 3~ 3~ 3~ 3~ 3~ 3~ 3~ 0~ 0~ 0~ 0~ 0~ 0~ 0~ 0~ 0~ 0~ 0~ 0~ 3~ 3~ 3~ 3~ 3~ 3~ 3~ 3~ 3~ 3~ 3~F1~ 3~ 3~ 3~ 3~ 3~ 3~ 3~ 3~ 3
~ 3~ 3~ 3~ 3~ 3~ 3~ 3~ 3~ 3~ 3~ 3~ 3~ 3~ 0~ 0~ 3~ 3~ 3~ 3~ 3~ 3~ 3~ 3~ 3~ 3~ 3~ 3~ 3~ 3~ 3~ 3~ 0~ 0~ 0~ 0~ 0~ 0~ 0~ 0~ 0~ 0~ 0~ 0~ 3~ 3~ 3~ 3~ 3~ 3~ 3~ 3~ 3~ 3~ 3~ 3~ 3~ 3~ 3~ 3~ 3~ 3~ 3~ 3~ 3
~ 3~ 3~ 3~ 3~ 3~ 3~ 3~ 3~ 3~ 3~ 3~ 3~ 3~ 0~ 0~ 3~ 3~ 3~ 3~ 3~ 3~ 3~ 3~ 3~ 3~ 3~ 3~ 3~ 3~ 3~ 3~ 0~ 0~ 0~ 0~ 0~ 0~ 0~ 0~ 0~ 0~ 0~ 0~ 3~ 3~ 3~ 3~ 3~ 3~ 3~ 3~ 3~ 3~ 3~ 3~ 3~ 3~ 3~F1~ 3~ 3~ 3~ 3~ 3
~ 3~ 3~ 3~ 3~ 3~ 3~ 3~ 3~ 3~ 3~ 3~ 3~ 3~ 0~ 0~ 0~ 0~ 0~ 0~ 0~ 0~ 0~ 0~ 0~ 0~ 0~ 0~ 0~ 0~ 0~ 0~ 0~ 0~ 0~ 0~ 0~ 0~ 0~ 0~ 0~ 0~ 0~ 0~ 3~ 3~ 3~ 3~ 3~ 3~ 3~ 3~ 3~ 3~ 3~ 3~ 3~ 3~ 3~ 3~ 3~ 3~ 3~ 3~ 3
