G 64 64

~ 0~ 0~ 0~ 0~ 0~ 0~ 0~ 0~ 0~ 0~ 0~ 0~ 0~ 0~ 0~ 0~ 0~ 0~ 0~ 0~ 0~ 0~ 0~ 0~ 0~ 0~ 0~ 0~ 0~ 0~ 0~ 0~ 0~ 0~ 0~ 0~ 0~ 0~ 0~ 0~ 0~ 0~ 0~ 0~ 0~ 0~ 0~ 0~ 0~ 0~ 0~ 0~ 0~ 0~ 0~ 0~ 0~ 0~ 0~ 0~ 0~ 0~ 0~ 0
~ 0~ 0~ 0~ 0~ 0~ 0~ 0~ 0~ 0~ 0~ 0~ 0~ 0~ 0~ 0~ 0~ 0~ 0~ 0~ 0~ 0~ 0~ 0~ 0~ 0~ 0~ 0~ 0~ 0~ 0~ 0~ 0~ 0~ 0~ 0~ 0~ 0~ 0~ 0~ 0~ 0~ 0~ 0~ 0~ 0~ 0~ 0~ 0~ 0~ 0~ 0~ 0~ 0~ 0~ 0~ 0~ 0~ 0~ 0~ 0~ 0~ 0~ 0~ 0
~ 0~ 0~ 0~ 0~ 0~ 0~ 0~ 0~ 0~ 0~ 0~ 0~ 0~ 0~ 0~ 0~ 0~ 0~ 0~ 0~ 0~ 0~ 0~ 0~ 0~ 0~ 0~ 0~ 0~ 0~ 0~ 0~ 0~ 0~ 0~ 0~ 0~ 0~ 0~ 0~ 0~ 0~ 0~ 0~ 0~ 0~ 0~ 0~ 0~ 0~ 0~ 0~ 0~ 0~ 0~ 0~ 0~ 0~ 0~ 0~ 0~ 0~ 0~ 0
~ 0~ 0~ 0~ 0~ 0~ 0~ 0~ 0~ 0~ 0~ 0~ 0~ 0~ 0~ 0~ 0~ 0~ 0~ 0~ 0~ 0~ 0~ 0~ 0~ 0~ 0~ 0~ 0~ 0~ 0~ 0~ 0~ 0~ 0~ 0~ 0~ 0~ 0~ 0~ 0~ 0~ 0~ 0~ 0~ 0~ 0~ 0~ 0~ 0~ 0~ 0~ 0~ 0~ 0~ 0~ 0~ 0~ 0~ 0~ 0~ 0~ 0~ 0~ 0
~ 0~ 0~ 0~ 0~ 0~ 0~ 0~ 0~ 0~ 0~ 0~ 0~ 0~ 0~ 0~ 0~ 0~ 0~ 0~ 0~ 0~ 0~ 0~ 0~ 0~ 0~ 0~ 0~ 0~ 0~ 0~ 0~ 0~ 0~ 0~ 0~ 0~ 0~ 0~ 0~ 0~ 0~ 0~ 0~ 0~ 0~ 0~ 0~ 0~ 0~ 0~ 0~ 0~ 0~ 0~ 0~ 0~ 0~ 0~ 0~ 0~ 0~ 0~ 0
~ 0~ 0~ 0~ 0~ 0~ 0~ 0~ 0~ 0~ 0~ 0~ 0~ 0~ 0~ 0~ 0~ 0~ 0~ 0~ 0~ 0~ 0~ 0~ 0~ 0~ 0~ 0~ 0~ 0~ 0~ 0~ 0~ 0~ 0~ 0~ 0~ 0~ 0~ 0~ 0~ 0~ 0~ 0~ 0~ 0~ 0~ 0~ 0~ 0~ 0~ 0~ 0~ 0~ 0~ 0~ 0~ 0~ 0~ 0~ 0~ 0~ 0~ 0~ 0
~ 0~ 0~ 0~ 0~ 0~ 0~ 0~ 0~ 0~ 0~ 0~ 0~ 0~ 0~ 0~ 0~ 0~ 0~ 0~ 0~ 0~ 0~ 0~ 0~ 0~ 0~ 0~ 0~ 0~ 0~ 0~ 0~ 0~ 0~ 0~ 0~ 0~ 0~ 0~ 0~ 0~ 0~ 0~ 0~ 0~ 0~ 0~ 0~ 0~ 0~ 0~ 0~ 0~ 0~ 0~ 0~ 0~ 0~ 0~ 0~ 0~ 0~ 0~ 0
~ 0~ 0~ 0~ 0~ 0~ 0~ 0~ 0~ 0~ 0~ 0~ 0~ 0~ 0~ 0~ 0~ 0~ 0~ 0~ 0~ 0~ 0~ 0~ 0~ 0~ 0~ 0~ 0~ 0~ 0~ 0~ 0~ 0~ 0~ 0~ 0~ 0~ 0~ 0~ 0~ 0~ 0~ 0~ 0~ 0~ 0~ 0~ 0~ 0~ 0~ 0~ 0~ 0~ 0~ 0~ 0~ 0~ 0~ 0~ 0~ 0~ 0~ 0~ 0
~ 0~ 0~ 0~ 0~ 0~ 0~ 0~ 0~ 0~ 0~ 0~ 0~ 0~ 0~ 0~ 0~ 0~ 0~ 0~ 0~ 0~ 0~ 0~ 0~ 0~ 0~ 0~ 0~ 0~ 0~ 0~ 0~ 0~ 0~ 0~ 0~ 0~ 0~ 0~ 0~ 0~ 0~ 0~ 0~ 0~ 0~ 0~ 0~ 0~ 0~ 0~ 0~ 0~*0~ 0~ 0~ 0~ 0~ 0~ 0~ 0~ 0~ 0~ 0
~ 0~ 0~ 0~ 0~ 0~ 0~ 0~ 0~ 0~ 0~ 0~ 0~ 0~ 0~ 0~ 0~ 0~ 0~ 0~ 0~ 0~ 0~ 0~ 0~ 0~ 0~ 0~ 0~ 0~ 0~ 0~ 0~ 0~ 0~ 0~ 0~ 0~ 0~ 0~ 0~ 0~ 0~ 0~ 0~ 0~ 0~ 0~ 0~ 0~ 0~ 0~ 0~ 0~ 0~ 0~ 0~ 0~ 0~ 0~ 0~ 0~ 0~ 0~ 0
~ 0~ 0~ 0~ 0~ 0~ 0~ 0~ 0~ 0~ 0~ 0~ 0~ 0~ 0~ 0~ 0~ 0~ 0~ 0~ 0~ 0~ 0~ 0~ 0~ 0~ 0~ 0~ 0~ 0~ 0~ 0~ 0~ 0~ 0~ 0~ 0~ 0~ 0~ 0~ 0~ 0~ 0~ 0~ 0~ 0~ 0~ 0~ 0~ 0~ 0~ 0~ 0~ 0~ 0~ 0~ 0~ 0~ 0~ 0~ 0~ 0~ 0~ 0~ 0
~ 0~ 0~ 0~ 0~ 0~ 0~ 0~ 0~ 0~ 0~ 0~ 0~ 0~ 0~ 0~ 0~ 0~ 0~ 0~ 0~ 0~ 0~ 0~ 0~ 0~ 0~ 0~ 0~ 0~ 0~ 0~ 0~ 0~ 0~ 0~ 0~ 0~ 0~ 0~ 0~ 0~ 0~ 0~ 0~ 0~ 0~ 0~ 0~*0~ 0~ 0~ 0~ 0~ 0~ 0~ 0~ 0~ 0~ 0~ 0~ 0~ 0~ 0~ 0
~ 0~ 0~ 0~ 0~ 0~ 0~ 0~ 0~ 0~ 0~ 0~ 0~ 0~ 0~ 0~ 0~ 0~ 0~ 0~ 0~ 0~ 0~ 0~ 0~ 0~ 0~ 0~ 0~ 0~ 0~ 0~ 0~ 0~ 0~ 0~ 0~ 0~ 0~ 0~ 0~ 0~ 0~ 0~ 0~ 0~ 0~ 0~ 0~ 0~ 0~ 0~ 0~*0~ 0~ 0~ 0~ 0~ 0~ 0~ 0~ 0~ 0~ 0~ 0
~ 0~ 0~ 0~ 0~ 0~ 0~ 0~ 0~ 0~ 0~ 0~ 0~ 0~ 0~ 0~ 0~ 0~ 0~ 0~ 0~ 0~ 0~ 0~ 0~ 0~ 0~ 0~ 0~ 0~ 0~ 0~ 0~ 0~ 0~ 0~ 0~ 0~ 0~ 0~ 0~ 0~ 0~ 0~ 0~ 0~ 0~ 0~ 0~ 0~ 0~ 0~ 0~ 0~ 0~ 0~ 0~*0~ 0~ 0~ 0~ 0~ 0~ 0~ 0
~ 0~ 0~ 0~ 0~ 0~ 0~ 0~ 0~ 0~ 0~ 0~ 0~ 0~ 0~ 0~ 0~ 0~ 0~ 0~ 0~ 0~ 0~ 0~ 0~ 0~ 0~ 0~ 0~ 0~ 0~ 0~ 0~ 0~ 0~ 0~ 0~ 0~ 0~ 0~ 0~ 0~ 0~ 0~ 0~ 0~ 0~ 0~ 0~ 0~ 0~ 0~ 0~ 0~ 0~ 0~ 0~ 0~ 0~ 0~ 0~ 0~ 0~ 0~ 0
~ 0~ 0~ 0~ 0~ 0~ 0~ 0~ 0~ 0~ 0~ 0~ 0~ 0~ 0~ 0~ 0~ 0~ 0~ 0~ 0~ 0~ 0~ 0~ 0~ 0~ 0~ 0~ 0~ 0~ 0~ 0~ 0~ 0~ 0~ 0~ 0~ 0~ 0~ 0~ 0~ 0~ 0~ 0~ 0~ 0~ 0~ 0~ 0~ 0~ 0~ 0~ 0~ 0~ 0~ 0~ 0~ 0~ 0~ 0~ 0~ 0~ 0~ 0~ 0
~ 0~ 0~ 0~ 0~ 0~ 0~ 0~ 0~ 0~ 0~ 0~ 0~ 0~ 0~ 0~ 0~ 0~ 0~ 0~ 0~ 0~ 0~ 0~ 0~ 0~ 0~ 0~ 0~ 0~ 0~ 0~ 0~ 0~ 0~ 0~ 0~ 0~ 0~ 0~ 0~ 0~ 0~ 0~ 0~ 0~ 0~ 0~ 0~ 0~ 0~*0~ 0~ 0~ 0~ 0~ 0~ 0~ 0~ 0~ 0~ 0~ 0~ 0~ 0
~ 0~ 0~ 0~ 0~ 0~ 0~ 0~ 0~ 0~ 0~ 0~ 0~ 0~ 0~ 0~ 0~ 0~ 0~ 0~ 0~ 0~ 0~ 0~ 0~ 0~ 0~ 0~ 0~ 0~ 0~ 0~ 0~ 0~ 0~ 0~ 0~ 0~ 0~ 0~ 0~ 0~ 0~ 0~ 0~ 0~ 0~ 0~ 0~ 0~ 0~ 0~ 0~ 0~ 0~ 0~ 0~ 0~ 0~ 0~ 0~ 0~ 0~ 0~ 0
~ 0~ 0~ 0~ 0~ 0~ 0~ 0~ 0~ 0~ 0~ 0~ 0~ 0~ 0~ 0~ 0~ 0~ 0~ 0~ 0~ 0~ 0~ 0~ 0~ 0~ 0~ 0~ 0~ 0~ 0~ 0~ 0~ 0~ 0~ 0~ 0~ 0~ 0~ 0~ 0~ 0~ 0~ 0~ 0~ 0~ 0~ 0~ 0~ 0~ 0~ 0~ 0~ 0~ 0~ 0~ 0~ 0~ 0~ 0~ 0~ 0~ 0~ 0~ 0
~ 0~ 0~ 0~ 0~ 0~ 0~ 0~ 0~ 0~ 0~ 0~ 0~ 0~ 0~ 0~ 0~ 0~ 0~ 0~ 0~ 0~ 0~ 0~ 0~ 0~ 0~ 0~ 0~ 0~ 0~ 0~ 0~ 0~ 0~ 0~ 0~ 0~ 0~ 0~ 0~ 0~ 0~ 0~ 0~ 0~ 0~ 0~ 0~ 0~ 0~ 0~ 0~ 0~ 0~ 0~ 0~ 0~ 0~ 0~ 0~ 0~ 0~ 0~ 0
~ 0~ 0~ 0~ 0~ 0~ 0~ 0~ 0~ 0~ 0~ 0~ 0~ 0~ 0~ 0~ 0~ 0~ 0~ 0~ 0~ 0~ 0~ 0~ 0~ 0~ 0~*0~ 0~ 0~ 0~ 0~ 0~ 0~ 0~ 0~ 0~ 0~ 0~ 0~ 0~ 0~ 0~ 0~ 0~ 0~ 0~ 0~ 0~ 0~ 0~ 0~ 0~ 0~ 0~ 0~ 0~ 0~ 0~ 0~ 0~ 0~ 0~ 0~ 0
~ 0~ 0~ 0~ 0~ 0~ 0~ 0~ 0~ 0~ 0~ 0~ 0~ 0~ 0~ 0~ 0~ 0~ 0~ 0~*3~ 3~ 3~ 3~ 3~ 3~ 3~ 3~ 3~ 3~ 3~ 3~ 3~ 3~ 3~ 3~ 0~ 0~ 0~ 0~ 0~ 0~ 0~ 0~ 0~ 0~ 0~ 0~ 0~ 0~ 0~ 0~ 0~ 0~ 0~ 0~ 0~ 0~ 0~ 0~ 0~ 0~ 0~ 0~ 0
~ 0~ 0~ 0~ 0~ 0~ 0~ 0~ 0~ 0~ 0~ 0~ 0~ 0~ 0~ 0~ 0~ 0~ 0~ 0~ 3~ 3~ 3~ 3~ 3~ 3~ 3~ 3~ 3~ 3~ 3~ 3~ 3~ 3~ 3~ 3~ 0~ 0~ 0~ 0~ 0~ 0~ 0~ 0~ 0~ 0~ 0~ 0~ 0~ 0~ 0~ 0~ 0~ 0~ 0~ 0~ 0~ 0~ 0~ 0~ 0~ 0~ 0~ 0~ 0
~ 0~ 0~ 0~ 0~ 0~ 0~ 0~ 0~ 0~ 0~ 0~ 0~ 0~ 0~ 0~ 0~ 0~ 0~ 0~ 3~ 3~ 3~ 3~ 3~ 3~ 3~ 3~ 3~ 3~ 3~ 3~ 3~ 3~ 3~ 3~ 0~ 0~ 0~ 0~ 0~ 0~ 0~ 0~ 0~ 0~ 0~ 0~ 0~ 0~ 0~ 0~ 0~ 0~ 0~*0~ 0~ 0~ 0~ 0~ 0~ 0~ 0~ 0~ 0
~ 0~ 0~ 0~ 0~ 0~ 0~ 0~ 0~ 0~ 0~ 0~ 0~ 0~ 0~ 0~ 0~ 0~ 0~ 0~ 3~ 3~ 3~ 3~ 3~ 3~ 3~ 3~ 3~ 3~*3~ 3~ 3~ 3~ 3~ 3~ 0~ 0~ 0~ 0~ 0~ 0~ 0~ 0~ 0~ 0~ 0~ 0~ 0~ 0~ 0~ 0~ 0~ 0~ 0~ 0~ 0~ 0~ 0~ 0~ 0~ 0~ 0~ 0~ 0
~ 0~ 0~ 0~ 0~ 0~ 0~ 0~ 0~ 0~ 0~ 0~ 0~ 0~ 0~ 0~ 0~ 0~ 0~ 0~ 3~ 3~ 3~ 3~*3~ 3~ 3~ 3~ 3~ 3~ 3~ 3~ 3~ 3~ 3~ 3~ 0~ 0~ 0~ 0~ 0~ 0~ 0~ 0~ 0~ 0~ 0~ 0~ 0~ 0~ 0~ 0~ 0~ 0~ 0~ 0~ 0~ 0~ 0~ 0~ 0~ 0~ 0~ 0~ 0
~ 0~ 0~ 0~ 0~ 0~ 0~ 0~ 0~ 0~ 0~ 0~ 0~ 0~ 0~ 0~ 0~ 0~ 0~ 0~ 3~ 3~ 3~ 3~ 3~ 3~ 3~ 3~ 3~ 3~ 3~ 3~ 3~ 3~ 3~ 3~ 0~ 0~ 0~ 0~ 0~ 0~ 0~ 0~ 0~ 0~ 0~ 0~ 0~ 0~ 0~ 0~ 0~ 0~ 0~ 0~ 0~ 0~ 0~ 0~ 0~ 0~ 0~ 0~ 0
~ 0~ 0~ 0~ 0~ 0~ 0~ 0~ 0~ 0~ 0~ 0~ 0~ 0~ 0~ 0~ 0~ 0~ 0~ 0~ 3~ 3~ 3~ 3~ 3~ 3~ 3~ 3~ 3~ 3~ 3~ 3~ 3~ 3~ 3~ 3~ 0~ 0~ 0~ 0~ 0~ 0~ 0~ 0~ 0~ 0~ 0~ 0~ 0~ 0~ 0~ 0~*0~ 0~ 0~ 0~ 0~ 0~*0~ 0~ 0~ 0~ 0~ 0~ 0
~ 0~ 0~ 0~ 0~ 0~ 0~ 0~ 0~ 0~ 0~ 0~ 0~ 0~ 0~ 0~ 0~ 0~ 0~ 0~ 3~ 3~ 3~ 3~ 3~ 3~ 3~ 3~G1~ 3~ 3~ 3~ 3~ 3~ 3~ 3~ 0~ 0~ 0~ 0~ 0~ 0~ 0~ 0~ 0~ 0~ 0~ 0~ 0~ 0~ 0~ 0~ 0~ 0~ 0~ 0~ 0~ 0~ 0~ 0~ 0~ 0~ 0~ 0~ 0
~ 0~ 0~ 0~ 0~ 0~ 0~ 0~ 0~ 0~ 0~ 0~ 0~ 0~ 0~ 0~ 0~ 0~ 0~ 0~ 3~ 3~ 3~ 3~ 3~ 3~ 3~ 3~ 3~ 3~ 3~ 3~ 3~ 3~ 3~ 3~ 0~ 0~ 0~ 0~ 0~ 0~ 0~ 0~ 0~ 0~ 0~ 0~ 0~ 0~*0~ 0~ 0~ 0~ 0~ 0~ 0~ 0~ 0~ 0~ 0~ 0~ 0~ 0~ 0
~ 0~ 0~ 0~ 0~ 0~ 0~ 0~ 0~ 0~ 0~ 0~ 0~ 0~ 0~ 0~ 0~ 0~ 0~ 0~ 3~ 3~ 3~ 3~ 3~ 3~ 3~ 3~ 3~ 3~ 3~ 3~ 3~ 3~ 3~ 3~ 0~ 0~ 0~ 0~ 0~ 0~ 0~ 0~ 0~ 0~ 0~ 0~ 0~ 0~ 0~ 0~ 0~ 0~ 0~ 0~ 0~ 0~ 0~ 0~ 0~ 0~ 0~ 0~ 0
~ 0~ 0~ 0~ 0~ 0~ 0~ 0~ 0~ 0~ 0~ 0~ 0~ 0~ 0~ 0~ 0~ 0~ 0~ 0~ 3~ 3~ 3~ 3~ 3~ 3~ 3~ 3~ 3~ 3~ 3~ 3~ 3~ 3~ 3~ 3~ 0~ 0~ 0~ 0~ 0~ 0~ 0~ 0~ 0~ 0~ 0~ 0~ 0~ 0~ 0~ 0~ 0~ 0~*0~ 0~ 0~ 0~ 0~ 0~ 0~ 0~ 0~ 0~ 0
~ 0~ 0~ 0~ 0~ 0~ 0~ 0~ 0~ 0~ 0~ 0~ 0~ 0~ 0~ 0~ 0~ 0~ 0~ 0~ 3~ 3~ 3~ 3~ 3~ 3~ 3~ 3~ 3~ 3~ 3~ 3~ 3~ 3~ 3~ 3~ 0~ 0~*0~ 0~ 0~ 0~ 0~ 0~ 0~ 0~ 0~ 0~ 0~ 0~ 0~ 0~ 0~ 0~ 0~ 0~ 0~ 0~ 0~ 0~ 0~ 0~ 0~ 0~ 0
~ 0~ 0~ 0~ 0~ 0~ 0~ 0~ 0~ 0~ 0~ 0~ 0~ 0~ 0~ 0~ 0~ 0~ 0~ 0~ 3~ 3~ 3~ 3~ 3~ 3~ 3~ 3~ 3~ 3~ 3~ 3~ 3~ 3~ 3~ 3~ 0~ 0~ 0~ 0~ 0~ 0~ 0~ 0~ 0~ 0~ 0~ 0~ 0~ 0~ 0~ 0~ 0~ 0~ 0~ 0~ 0~ 0~ 0~ 0~ 0~ 0~ 0~ 0~ 0
~ 0~ 0~ 0~ 0~ 0~ 0~ 0~ 0~ 0~ 0~ 0~ 0~ 0~ 0~ 0~ 0~ 0~ 0~ 0~ 3~*3~ 3~ 3~ 3~ 3~ 3~ 3~ 3~ 3~ 3~ 3~ 3~ 3~ 3~ 3~ 0~ 0~ 0~ 0~ 0~ 0~ 0~ 0~ 0~ 0~ 0~ 0~ 0~ 0~ 0~ 0~ 0~ 0~ 0~ 0~ 0~ 0~ 0~ 0~ 0~ 0~ 0~ 0~ 0
~ 0~ 0~ 0~ 0~ 0~ 0~ 0~ 0~ 0~ 0~ 0~ 0~ 0~ 0~ 0~ 0~ 0~ 0~ 0~ 3~ 3~ 3~ 3~ 3~ 3~ 3~ 3~ 3~ 3~ 3~ 3~ 3~ 3~ 3~ 3~ 0~ 0~ 0~ 0~ 0~ 0~ 0~ 0~ 0~ 0~ 0~ 0~ 0~ 0~ 0~ 0~ 0~ 0~ 0~ 0~ 0~ 0~ 0~ 0~ 0~ 0~ 0~ 0~ 0
~ 0~ 0~ 0~ 0~ 0~ 0~ 0~ 0~ 0~ 0~ 0~ 0~ 0~ 0~ 0~ 0~ 0~ 0~ 0~ 3~ 3~ 3~ 3~ 3~*3~ 3~ 3~ 3~ 3~ 3~ 3~ 3~*3~ 3~ 3~ 0~ 0~ 0~ 0~ 0~*0~ 0~ 0~ 0~ 0~ 0~ 0~ 0~ 0~ 0~ 0~ 0~ 0~ 0~ 0~ 0~ 0~ 0~ 0~ 0~ 0~ 0~ 0~ 0
~ 0~ 0~ 0~ 0~ 0~ 0~ 0~ 0~ 0~ 0~ 0~ 0~ 0~ 0~ 0~*0~ 0~ 0~ 0~ 0~ 0~ 0~ 0~ 0~ 0~ 0~ 0~ 0~ 0~ 0~ 0~ 0~ 0~ 0~ 0~ 0~*0~ 0~ 0~ 0~ 0~ 0~ 0~ 0~ 0~ 0~ 0~ 0~ 0~ 0~ 0~ 0~ 0~ 0~ 0~ 0~ 0~ 0~ 0~ 0~ 0~ 0~ 0~ 0
~ 0~ 0~ 0~ 0~ 0~ 0~ 0~ 0~ 0~ 0~ 0~ 0~ 0~ 0~ 0~ 0~ 0~ 0~ 0~ 0~ 0~ 0~ 0~ 0~ 0~ 0~ 0~ 0~ 0~ 0~ 0~ 0~ 0~ 0~ 0~ 0~ 0~ 0~ 0~ 0~ 0~ 0~ 0~ 0~ 0~ 0~ 0~ 0~ 0~ 0~ 0~ 0~ 0~ 0~ 0~ 0~ 0~ 0~ 0~ 0~ 0~ 0~ 0~ 0
~ 0~ 0~ 0~ 0~ 0~ 0~ 0~ 0~ 0~ 0~ 0~ 0~ 0~ 0~ 0~ 0~ 0~ 0~ 0~ 0~ 0~ 0~ 0~ 0~ 0~ 0~ 0~ 0~ 0~ 0~ 0~ 0~ 0~ 0~ 0~ 0~ 0~ 0~ 0~ 0~ 0~ 0~ 0~ 0~ 0~ 0~ 0~ 0~ 0~ 0~ 0~ 0~ 0~ 0~*0~ 0~ 0~ 0~ 0~ 0~ 0~ 0~ 0~ 0
~ 0~ 0~ 0~ 0~ 0~ 0~ 0~ 0~ 0~ 0~ 0~ 0~ 0~ 0~ 0~ 0~ 0~ 0~ 0~ 0~ 0~ 0~ 0~*0~ 0~ 0~ 0~ 0~ 0~ 0~ 0~ 0~ 0~ 0~ 0~ 0~ 0~ 0~ 0~ 0~ 0~ 0~ 0~ 0~ 0~ 0~ 0~ 0~ 0~ 0~ 0~ 0~ 0~ 0~ 0~ 0~ 0~ 0~ 0~ 0~ 0~ 0~ 0~ 0
~ 0~ 0~ 0~ 0~ 0~ 0~ 0~ 0~ 0~ 0~ 0~ 0~ 0~ 0~ 0~ 0~ 0~ 0~*0~ 0~ 0~ 0~ 0~ 0~ 0~ 0~ 0~ 0~ 0~ 0~ 0~ 0~ 0~ 0~ 0~ 0~*0~ 0~ 0~ 0~ 0~ 0~ 0~ 0~ 0~ 0~ 0~ 0~ 0~ 0~*0~ 0~ 0~ 0~ 0~ 0~ 0~ 0~ 0~ 0~ 0~ 0~ 0~ 0
~ 0~ 0~ 0~ 0~ 0~ 0~ 0~ 0~ 0~ 0~ 0~ 0~ 0~ 0~ 0~ 0~ 0~ 0~ 0~ 0~ 0~ 0~ 0~ 0~ 0~ 0~ 0~ 0~ 0~ 0~ 0~ 0~ 0~ 0~ 0~ 0~ 0~ 0~ 0~ 0~ 0~ 0~ 0~ 0~ 0~ 0~ 0~ 0~ 0~ 0~ 0~ 0~ 0~ 0~ 0~ 0~ 0~ 0~ 0~ 0~ 0~ 0~ 0~ 0
~ 0~ 0~ 0~ 0~ 0~ 0~ 0~ 0~ 0~ 0~ 0~ 0~ 0~ 0~ 0~ 0~ 0~ 0~ 0~ 0~ 0~ 0~ 0~ 0~ 0~ 0~ 0~ 0~ 0~ 0~ 0~ 0~ 0~ 0~ 0~ 0~ 0~ 0~ 0~ 0~ 0~ 0~ 0~ 0~ 0~ 0~ 0~ 0~ 0~ 0~ 0~ 0~ 0~ 0~ 0~ 0~ 0~ 0~ 0~ 0~ 0~ 0~ 0~ 0
~ 0~ 0~ 0~ 0~ 0~ 0~ 0~ 0~ 0~ 0~ 0~ 0~ 0~ 0~ 0~ 0~ 0~ 0~ 0~ 0~ 0~ 0~ 0~ 0~ 0~ 0~ 0~ 0~ 0~ 0~ 0~ 0~ 0~ 0~ 0~ 0~ 0~ 0~ 0~ 0~ 0~ 0~ 0~ 0~ 0~ 0~ 0~ 0~ 0~ 0~ 0~ 0~ 0~ 0~ 0~ 0~ 0~ 0~ 0~ 0~ 0~ 0~ 0~ 0
~ 0~ 0~ 0~ 0~ 0~ 0~ 0~ 0~ 0~ 0~ 0~ 0~ 0~ 0~ 0~ 0~ 0~ 0~ 0~ 0~ 0~ 0~ 0~ 0~ 0~ 0~ 0~ 0~ 0~ 0~ 0~ 0~ 0~ 0~ 0~ 0~ 0~ 0~ 0~ 0~ 0~ 0~ 0~ 0~ 0~ 0~ 0~*0~ 0~ 0~ 0~ 0~ 0~ 0~ 0~ 0~*0~ 0~ 0~ 0~ 0~ 0~ 0~ 0
~ 0~ 0~ 0~ 0~ 0~ 0~ 0~ 0~ 0~ 0~ 0~ 0~ 0~ 0~ 0~ 0~ 0~ 0~ 0~ 0~ 0~ 0~ 0~ 0~ 0~ 0~ 0~ 0~ 0~ 0~ 0~ 0~ 0~ 0~ 0~ 0~ 0~ 0~ 0~ 0~ 0~ 0~ 0~ 0~ 0~ 0~ 0~ 0~ 0~ 0~ 0~*0~ 0~ 0~ 0~ 0~ 0~ 0~ 0~ 0~ 0~ 0~ 0~ 0
~ 0~ 0~ 0~ 0~ 0~ 0~ 0~ 0~ 0~ 0~ 0~ 0~ 0~ 0~ 0~ 0~ 0~ 0~ 0~ 0~ 0~ 0~ 0~ 0~ 0~ 0~ 0~ 0~ 0~ 0~ 0~ 0~ 0~ 0~ 0~ 0~ 0~ 0~ 0~ 0~ 0~ 0~ 0~ 0~ 0~ 0~ 0~ 0~ 0~ 0~ 0~ 0~ 0~ 0~ 0~ 0~ 0~ 0~ 0~ 0~ 0~ 0~ 0~ 0
~ 0~ 0~ 0~ 0~ 0~ 0~ 0~ 0~ 0~ 0~ 0~ 0~ 0~ 0~ 0~ 0~ 0~ 0~ 0~ 0~ 0~ 0~ 0~ 0~ 0~ 0~ 0~ 0~ 0~ 0~ 0~ 0~ 0~ 0~ 0~ 0~ 0~ 0~ 0~ 0~ 0~ 0~ 0~ 0~ 0~ 0~ 0~ 0~ 0~ 0~ 0~ 0~ 0~ 0~ 0~ 0~ 0~ 0~ 0~ 0~ 0~ 0~ 0~ 0
~ 0~ 0~ 0~ 0~ 0~ 0~ 0~ 0~ 0~ 0~ 0~ 0~ 0~ 0~ 0~ 0~ 0~ 0~ 0~ 0~ 0~ 0~ 0~ 0~ 0~ 0~ 0~ 0~ 0~ 0~ 0~ 0~ 0~ 0~ 0~ 0~ 0~ 0~ 0~ 0~ 0~ 0~ 0~ 0~ 0~ 0~ 0~ 0~ 0~ 0~ 0~ 0~ 0~ 0~ 0~ 0~ 0~ 0~ 0~ 0~ 0~ 0~ 0~ 0
~ 0~ 0~ 0~ 0~ 0~ 0~ 0~ 0~ 0~*0~ 0~ 0~ 0~ 0~ 0~ 0~ 0~ 0~ 0~ 0~ 0~ 0~ 0~ 0~*0~ 0~ 0~ 0~ 0~ 0~ 0~ 0~ 0~ 0~ 0~ 0~ 0~ 0~ 0~ 0~ 0~ 0~ 0~ 0~ 0~ 0~ 0~ 0~ 0~ 0~ 0~ 0~ 0~ 0~ 0~ 0~ 0~ 0~ 0~ 0~ 0~ 0~ 0~ 0
~ 0~ 0~ 0~ 0~ 0~ 0~ 0~ 0~ 0~ 0~ 0~ 0~ 0~ 0~ 0~ 0~ 0~ 0~ 0~ 0~*0~ 0~ 0~ 0~ 0~ 0~ 0~ 0~ 0~ 0~ 0~ 0~ 0~ 0~ 0~ 0~ 0~ 0~ 0~ 0~ 0~ 0~ 0~ 0~ 0~ 0~ 0~ 0~ 0~ 0~ 0~ 0~ 0~ 0~ 0~ 0~ 0~ 0~ 0~ 0~ 0~ 0~ 0~ 0
~ 0~ 0~ 0~ 0~ 0~ 0~ 0~ 0~ 0~ 0~ 0~ 0~*0~ 0~ 0~ 0~ 0~ 0~ 0~ 0~ 0~ 0~ 0~ 0~ 0~ 0~ 0~ 0~ 0~ 0~ 0~ 0~ 0~ 0~ 0~ 0~ 0~ 0~ 0~ 0~ 0~ 0~ 0~ 0~ 0~ 0~ 0~ 0~ 0~ 0~ 0~ 0~ 0~ 0~ 0~ 0~ 0~ 0~ 0~ 0~ 0~ 0~ 0~ 0
~ 0~ 0~ 0~ 0~ 0~*0~ 0~ 0~ 0~ 0~ 0~ 0~ 0~ 0~ 0~ 0~ 0~ 0~ 0~ 0~ 0~ 0~ 0~ 0~ 0~ 0~ 0~ 0~ 0~ 0~ 0~ 0~ 0~ 0~ 0~ 0~ 0~ 0~ 0~ 0~ 0~ 0~ 0~ 0~ 0~ 0~ 0~ 0~ 0~ 0~ 0~ 0~ 0~ 0~ 0~ 0~ 0~ 0~ 0~ 0~ 0~ 0~ 0~ 0
~ 0~ 0~ 0~ 0~ 0~ 0~ 0~ 0~ 0~ 0~ 0~ 0~ 0~ 0~ 0~ 0~ 0~ 0~ 0~ 0~ 0~ 0~ 0~ 0~ 0~ 0~*0~ 0~ 0~ 0~ 0~ 0~ 0~ 0~ 0~ 0~ 0~ 0~ 0~ 0~ 0~ 0~ 0~ 0~ 0~ 0~ 0~ 0~ 0~ 0~ 0~ 0~ 0~ 0~ 0~ 0~ 0~ 0~ 0~ 0~ 0~ 0~ 0~ 0
~ 0~ 0~ 0~ 0~ 0~ 0~ 0~ 0~ 0~ 0~ 0~ 0~ 0~ 0~ 0~ 0~ 0~ 0~ 0~ 0~ 0~*0~ 0~ 0~ 0~ 0~ 0~ 0~ 0~ 0~ 0~ 0~ 0~ 0~ 0~ 0~ 0~ 0~ 0~ 0~ 0~ 0~ 0~ 0~ 0~ 0~ 0~ 0~ 0~ 0~ 0~ 0~ 0~ 0~ 0~ 0~ 0~ 0~ 0~ 0~ 0~ 0~ 0~ 0
~ 0~ 0~ 0~ 0~ 0~ 0~ 0~ 0~ 0~ 0~*0~ 0~ 0~ 0~ 0~ 0~ 0~ 0~ 0~ 0~ 0~ 0~ 0~ 0~ 0~ 0~ 0~ 0~ 0~ 0~ 0~ 0~ 0~ 0~ 0~ 0~ 0~ 0~ 0~ 0~ 0~ 0~ 0~ 0~ 0~ 0~ 0~ 0~ 0~ 0~ 0~ 0~ 0~ 0~ 0~ 0~ 0~ 0~ 0~ 0~ 0~ 0~ 0~ 0
~ 0~ 0~ 0~ 0~ 0~ 0~*0~ 0~ 0~ 0~ 0~ 0~ 0~ 0~ 0~ 0~ 0~ 0~ 0~ 0~ 0~ 0~ 0~ 0~ 0~ 0~ 0~ 0~ 0~ 0~ 0~ 0~ 0~ 0~ 0~ 0~ 0~ 0~ 0~ 0~ 0~ 0~ 0~ 0~ 0~ 0~ 0~ 0~ 0~ 0~ 0~ 0~ 0~ 0~ 0~ 0~ 0~ 0~ 0~ 0~ 0~ 0~ 0~ 0
~ 0~ 0~ 0~ 0~ 0~ 0~ 0~ 0~ 0~ 0~ 0~ 0~ 0~ 0~ 0~ 0~ 0~ 0~ 0~ 0~ 0~ 0~ 0~ 0~ 0~ 0~ 0~ 0~ 0~ 0~ 0~ 0~ 0~ 0~ 0~ 0~ 0~ 0~ 0~ 0~ 0~ 0~ 0~ 0~ 0~ 0~ 0~ 0~ 0~ 0~ 0~ 0~ 0~ 0~ 0~ 0~ 0~ 0~ 0~ 0~ 0~ 0~ 0~ 0
~ 0~ 0~ 0~ 0~ 0~ 0~ 0~ 0~ 0~ 0~ 0~ 0~ 0~ 0~ 0~ 0~ 0~ 0~ 0~ 0~ 0~ 0~ 0~*0~ 0~ 0~ 0~ 0~ 0~ 0~ 0~ 0~ 0~ 0~ 0~ 0~ 0~ 0~ 0~ 0~ 0~ 0~ 0~ 0~ 0~ 0~ 0~ 0~ 0~ 0~ 0~ 0~ 0~ 0~ 0~ 0~ 0~ 0~ 0~ 0~ 0~ 0~ 0~ 0
~ 0~ 0~ 0~ 0~ 0~ 0~ 0~ 0~ 0~ 0~ 0~ 0~ 0~ 0~ 0~ 0~ 0~ 0~ 0~ 0~ 0~ 0~ 0~ 0~ 0~ 0~ 0~ 0~ 0~ 0~ 0~ 0~ 0~ 0~ 0~ 0~ 0~ 0~ 0~ 0~ 0~ 0~ 0~ 0~ 0~ 0~ 0~ 0~ 0~ 0~ 0~ 0~ 0~ 0~ 0~ 0~ 0~ 0~ 0~ 0~ 0~ 0~ 0~ 0
~ 0~ 0~ 0~ 0~ 0~ 0~ 0~ 0~ 0~ 0~ 0~ 0~ 0~ 0~ 0~ 0~ 0~ 0~ 0~ 0~ 0~ 0~ 0~ 0~ 0~ 0~ 0~ 0~ 0~ 0~ 0~ 0~ 0~ 0~ 0~ 0~ 0~ 0~ 0~ 0~ 0~ 0~ 0~ 0~ 0~ 0~ 0~ 0~ 0~ 0~ 0~ 0~ 0~ 0~ 0~ 0~ 0~ 0~ 0~ 0~ 0~ 0~ 0~ 0
~ 0~ 0~ 0~ 0~ 0~ 0~ 0~ 0~ 0~ 0~ 0~ 0~ 0~ 0~ 0~ 0~ 0~ 0~ 0~ 0~ 0~ 0~ 0~ 0~ 0~ 0~ 0~ 0~ 0~ 0~ 0~ 0~ 0~ 0~ 0~ 0~ 0~ 0~ 0~ 0~ 0~ 0~ 0~ 0~ 0~ 0~ 0~ 0~ 0~ 0~ 0~ 0~ 0~ 0~ 0~ 0~ 0~ 0~ 0~ 0~ 0~ 0~ 0~ 0
~ 0~ 0~ 0~ 0~ 0~ 0~ 0~ 0~ 0~ 0~ 0~ 0~ 0~ 0~ 0~ 0~ 0~ 0~ 0~ 0~ 0~ 0~ 0~ 0~ 0~ 0~ 0~ 0~ 0~ 0~ 0~ 0~ 0~ 0~ 0~ 0~ 0~ 0~ 0~ 0~ 0~ 0~ 0~ 0~ 0~ 0~ 0~ 0~ 0~ 0~ 0~ 0~ 0~ 0~ 0~ 0~ 0~ 0~ 0~ 0~ 0~ 0~ 0~ 0
